NO texture/greystone.xpm
SO texture/colorstone.xpm
WE texture/greystone.xpm
EA texture/greystone.xpm

F 220,100,0
C 225,30,0

1111111
1000001
1000001
1000001
1000S01
1111111
