NO ./images/NO.xpm
SO ./images/SO.xpm
WE ./images/WE.xpm
EA ./images/EA.xpm
F 0,153,15
C 255,255,255

        1111111111111111111111111
        1000030000000000000000001
        1100012100000000000000001
        1000000000000000000000001
111111111000000000000000000000001
100000000000000000000100000001111
10000000000000W10000020000001
10000300000000000000010000001
10000000000000000000000000001
10000000300000000000000000001
10000000000000000001010000001
11000001110101011111011110101
11110111 1110111 101111010001
11111111 1111111 111111111111
